BBBBBBBBBBBBBBBBBBBBBBBBBBBB
BBBBBBBBBBBBBBBBBBBBBBBBBBBB
BBBBBBBBBBBBBBBBBBBBBBBBBBBB
BBBCCCCCCCCCCCCCCCCCCCCCCBBB
BBBCBBBBBBBBBBBCBBBBBBBBCBBB
BBBCBBBBBBBBBBBCBBBBBBBBCBBB
BBBCBBCCCBCCCBCCCBCCCBBBCBBB
BBBCBBCCCCCCCBCCCBCCCBBBCBBB
BBBCBBCCCBCCCBCCCBCCCBBBCBBB
BBBCBBBBBBBCBBBCBBBCBBBBCBBB
BBBCBBCCCBBCBBBCBBBCBCCBCBBB
BBBCCCCCCCCCCCCCCCCCCCCBCBBB
BBBCBBCCCBBCBBBBBBBCBCCBCBBB
BBBCBBBCBBBCBBBBBBBCBBBBCBBB
BBBCBBCCCBCCCBCCCBCCCBBBCBBB
BBBCBBCCCBCCCCCCCBCCCBBBCBBB
BBBCBBCCCBCCCBCCCBCCCBBBCBBB
BBBCBBBCBBBBBBBCBBBBBBBBCBBB
BBBCBBCCCBBBBCCCCCBBCCCBCBBB
BBBCBBCCCBBBBCCCCCBBCCCBCBBB
BBBCBBBBBBBBBBBBBBBBBCBBCBBB
BBBCCCCCCCCCCCCCCCCCCCCCCBBB
BBBBBBCBBBBBBBCBBBBBBCBBBBBB
BBBBBBCBBBBBBBCBBBBBBCBBBBBB
BBBBCCCCCBBBCCCCCBBCCCCCBBBB
BBBBCCCCCBBBCCCCCBBCCCCCBBBB
BBBBCCCCCBBBCCCCCBBCCCCCBBBB
BBBBBBBBBBBBBBBBBBBBBBBBBBBB