BBBBBBBBBBBBBBBBBBBBBBBBBBBB
BBCCCCCBBBBBCCCBBBBBBBBBBBBB
BBCCCCCCCCBBCCCBBBCCCCBBBBBB
BBCCCCCBBCBBCCCBBBBBBCBBBBBB
BBBBCBBBBCBBBCBBBBBBBCBCCCCB
BBBBCBBBBCCCCCCCCCCBBCCCCCCB
BBBBCBBBBBBBBCBBBBCBBBBCCCCB
BBCCCCCBBBBBBBBBBBCBBBBCCCCB
BBCCCCCCCCCCCCCCCCCBBBBBBCBB
BBCCCCCBBBBBBBBBBBBBBBBBBCBB
BBBBCBBBBBBBBBBCCCCCCCCBBCBB
BBBBCBBBBBBBBBBCCCCCCCCBBCBB
BBBBCBBCCCCCCBBCCCCCCCCBBCBB
BBCCCCCCCCCCCCCCBBBCBBBBBCBB
BBBBBBBCCCCCCBBBBBBCBBBBBCBB
BBBBCBBBBCBBBBBBBCCCCCBBBCBB
BBBBCBBBBCBBBBBBBCCCCCCCCCBB
BBBBCBBBBCCCCCBBBCCCCCBBBCBB
BBCCCCBBBCBBBCBBBBBCBBBBBCBB
BBCBBCBBBCBBBCBBBBBCBBBBBCBB
BBCBBCBBCCCCCCCCCCCCCCCCCCBB
BBCBBBBBBBBBBBBBBBCBBBBCBBBB
BBCCCCCCBBCCCCCCCCCCCCBCBBBB
BBCBBCCCBBCBBCBBBBCBBBBCBBBB
BBCBBCCCBBCBBCBBBBCBBCCCCCBB
BBCBBCCCCCCBCCCBBBCCCCCCCCBB
BBBBBBBBBBBBCCCBBBBBBBBBBBBB
BBBBBBBBBBBBBBBBBBBBBBBBBBBB