BBBBBBBBBBBBBBBBBBBBBBBBBBBB
BCCCBBBBBBBBBBBBBBBBBCCCBBBB
BCCCBBBBBBBBCCCBBBBBBCCCBBBB
BBCBBBBCCCCCCCCBBBBBBCCCBBBB
BBCBBBBCBBBBCCCBBBBBBBCBBBBB
BBCCCCCCBBBBBBBBBBBBBBCBBBBB
BBCBBBBBBBBBBBBBBBBBBBCBBBBB
BBCBBBBBBBBBBBBBBBBCCCCCCCBB
BBCBBBBBBBBCCCCCBBBCCCCCCCBB
BBCCCCCCBBBCCCCCBBBCCCCCCCBB
BBBCBBBCBBBCCCCCBBBCCCCCCCBB
BBBCBBBCBBBBBCBBBBBBBBCBBBBB
BBCCCBBCBBBBBCBBBBBBBBCBBBBB
BBCCCBBCBBBBBCBBBBBBCCCCCBBB
BBCCCBBCBBBBBCBBBBBBCBBBCBBB
BBBBBBBCCCCCCCCCCCCCCBBBCBBB
BBBBBBBCBBBBBBBBBBBBCBBBCBBB
BBBBBBBCBBBBBBBBBBBBCBBBCBBB
BBCCCBBCBBCCCBBBBBCCCCBBCBBB
BBCCCCCCCCCCCBBBBBCCCCBBCBBB
BBCCCBBCBBCCCBBBBBCCCCBBCBBB
BBBBBBBCBBBBBBBBBBBBBBBBCBBB
BBBBBBBCBBBBBBCCCCCCCCCCCBBB
BBBBBBCCCCBBBBCBBBBBBBBBBBBB
BBBBBBCCCCBBBBCBBBBBBBBBBBBB
BBBBBBCCCCBBCCCCCBBBBBBBBBBB
BBBBBBBBBBBBCCCCCBBBBBBBBBBB
BBBBBBBBBBBBBBBBBBBBBBBBBBBB